# sub-type	super-type
boolean	object
byte	object
numeric	object
text	object

byte	short
short	int
int	long
long	integer
integer decimal


unsignedByte	unsignedShort
unsignedInt	unsignedLong
unsignedLong	nonNegativeInteger
nonNegativeInteger	integer

negativeInteger	nonPositiveInteger
nonPositiveInteger	integer

decimal	numeric
float	numeric
double	numeric

timestamp	date